y y y y y y y y y y y y y y y y y y y y y y
y y y r r y y y y y y y y y y y y y y y y y
y y r y y r y y y y y y y y y y y y y y y y
y y y r y r y y y y y y y y y y y y y y y y
y y y y r r y y y y y y y y y y y y y y y y
y y y r y r y y y y y y y y y y y y y y y y
y y r y y r y y y y y y y y y y y y y y y y
y y y y y y y y y y y y y y y y y y y y y y